█████████████████████████████████████████
█.......█.....█.........█.....█.....█...█
███.█████.███.█.███████.█.█.█.███.█.█.███
█...█.....█.█...█.....█.█.█.█...█.█.█...█
█.███.█████.█████.█.███.█.█.███.█.█.███.█
█...█.█.......█...█.█...█.█...█.█.█...█.█
███.█.█████.█.█.█.█.█.███.███.█.█.███.█.█
█...█.......█.█.█.█.█.....█...█...█.....█
█.█.█████████.███.█████████.█.███████████
█.█.....█.....█...█.........█.█.........█
█.█████.█.█████.█.█.███████.███.███████.█
█...█...█...█...█.█.█...█...█...█.....█.█
█.█.███████.███.█.█.█.█.█.███.███.███.█.█
█.█.......█.....█.█.█.█.....█.█...█...█.█
███████.█████████.█.█████████.███.█.███.█
█.....█...........█.....█.........█.█.█.█
█.███.█.███████████████.█.█████████.█.█.█
█...█.█.........█.....█...█.....█.....█.█
███.█.███████████.███.█████.███.███████.█
█.█.█.█.......█...█.......█.█.█.......█.█
█.█.█.█.█████.█.█████████.█.█.█.█████.█.█
█.█.█.█...█.....█....S█.█.█.█...█...█...█
█.█.█.███.███.███.█████.█.█.█████.█.█████
█.█.█...█...█.█...█...█...█...█...█.....█
█.█.███.███.███.███.███.███.█.█.███████.█
█.█...█.....█...█.......█...█...█.█.....█
█.███.███████.███.███████████.███.█.███.█
█...█.....█...█.█.█.........█.█...█...█.█
███.█████.█.███.█.█.█.█████.█.█.█████.█.█
█.......█...█...█.█.█...█...█...█.....█.█
█.█████.█████.█.█.█████.█.█████.█.█████.█
█.█.....█.....█.█.......█.█...█.█.█...█.█
█.█████.█.█████.█████████.█.█.█.█.███.█.█
█.█...█o█.█...█.....█...█...█.█.█...█...█
█.█.█.███.█.█████.█.█.█.█████.█████.███.█
█...█...█.█.█.....█...█.....█.....█...█.█
█.█████.█.█.█.███████.█████.█████.█.█.███
█...█.█.█...█.█...█...█...█.█.....█.█...█
███.█.█.███.█.█.█.█████.█.███.█████████.█
█.....█.....█...█.......█...............█
█████████████████████████████████████████